111111111111111111111111111111111111111111111111111
100000000002000000000000000000000000000000000000001
100000000002000111111111111111001001110001111100001
100111111111000000000000000001001000100001000000001
100100000001000000000000000001001000100001001111001
100111110000000001111111111001001000100001001001001
100000020000000001000000001001001000100001002001001
100000020000011111111000001001001000100001002001001
100000020000000000000000001001001000100001002001001
100100010000100000000000001001001000100001002001001
100100010011111111111000001001002222200001001001001
100100110000100000000000001000000000000000001001001
100100000000000001111110001000000000000000001000001
100100000000000001000000001000000000000000001000001
100100111111100001000000000001111000010000001000001
100100000010000001000000000001000000010000001000001
100111110010000001000000000001000000010000001000001
100000000010000000000000000001000000010000001000001
100000000010000000001112221111111100010000001000001
100000000000001111111000000001000000010000001000001
100000000000000000001000000001000000010000001000001
100100000000000000001000010000000000011111111111001
100111111111110000001111110000000000000000000000001
100000000000000000000000000000000000000000000000001
111111111111111111111111111111111111111111111111111